111111111111111111111111111111111111111111111
100222222222222222222220022222222222222222221
120022222222222222222200002222222222222222221
122002222222222222222002200222222222222222221
122200222222222222220022220022222222222222001
122220022222222222200222222002222222222220021
122222002222222222002222222200222222222200221
122222200222222220022222222220022222222002221
122222220022222200222222222222002222220022221
122222222002222002222222222222200222200222221
122222222200220022222222222222220022002222221
122222222220000222222222222222222000022222221
122222222222002222222222222222222200222222221
100000000000000000000000000000000000000000001
100000000000000000000000000000000000000000001
100000000000000000000000000000000000000000001
100000000000000000000000000000000000000000001
100000000000000000000000000000000000000000001
100000000000000000000000000000000000000000001
100000000000000000000000000000000000000000001
100000000000000000000000000000000000000000001
100000000000000000000000000000000000000000001
100000000000000000000000000000000000000000001
100000000000000000000000000000000000000000001
100000000000000000000000000000000000000000001
100000000000000000000000000000000000000000001
111111111111111111111111111111111111111111111