111111111111111111111111111111111111111111111
122222222222222222222222222222222222222222221
122222222222222222220000222222222222222222221
122222222222220000000000000002222222222222221
122222222200000000000000000000000022222222221
122222200000000000000000000000000000000222221
122222222222222222222222222222222222222222221
122222222222222222222222222222222222222222221
122222200000000000000000000000000000000222221
122222222200000000000000000000000022222222221
122222222222220000000000000002222222222222221
122222222222222222220000222222222222222222221
100000000000000000000000000000000000000000001
100000000000000000000000000000000000000000001
100000000000000000000000000000000000000000001
100000000000000000000000000000000000000000001
100000000000000000000000000000000000000000001
100000000000000000000000000000000000000000001
100000000000000000000000000000000000000000001
100000000000000000000000000000000000000000001
100000000000000000000000000000000000000000001
100000000000000000000000000000000000000000001
100000000000000000000000000000000000000000001
100000000000000000000000000000000000000000001
100000000000000000000000000000000000000000001
100000000000000000000000000000000000000000001
111111111111111111111111111111111111111111111