111111111111111111111111111
122222222222222222222222221
122222222220000222222222221
122220000000000000002222221
100000000000000000000000021
100000000000000000000000001
122222222222222222222222221
122222222222222222222222221
100000000000000000000000001
100000000000000000000000021
122220000000000000002222221
122222222220000222222222221
100000000000000000000000001
100000000000000000000000001
100000000000000000000000001
100000000000000000000000001
100000000000000000000000001
100000000000000000000000001
100000000000000000000000001
100000000000000000000000001
100000000000000000000000001
100000000000000000000000001
100000000000000000000000001
100000000000000000000000001
100000000000000000000000001
100000000000000000000000001
111111111111111111111111111