111111111111111111111111111111111111111111111
100000000000000000000000000000000000000000001
100000000000000000000000000000000000000000001
100222222222222222222222222222222222222222001
100200000000000000000000000000000000000002001
100200000000000000000000000000000000000002001
100200222222222222222222222222222222222002001
100200200000000000000000000000000000000002001
100200200000000000000000000000000000000002001
100200200000000000000000000000000000000002001
100200222222222222222222222222222222222222001
100200000000000000000000000000000000000000001
100200000000000000000000000000000000000000001
100222222222222222222222222222222222222222221
100000000000000000000000000000000000000000001
100000000000000000000000000000000000000000001
100000000000000000000000000000000000000000001
100000000000000000000000000000000000000000001
100000000000000000000000000000000000000000001
100000000000000000000000000000000000000000001
100000000000000000000000000000000000000000001
100000000000000000000000000000000000000000001
100000000000000000000000000000000000000000001
100000000000000000000000000000000000000000001
100000000000000000000000000000000000000000001
100000000000000000000000000000000000000000001
111111111111111111111111111111111111111111111